20 20
||||||||||||||||||||
||.|...||P||.|.|..||
|...|||......||..|.|
|||.|...|||..|.||..|
|....||..||...||.|||
|.||.||....||.|..|.|
|.||.||.||...|.|...|
|||....|...|||.|.|||
|.|.|.|..|.|...|.|||
|.|.|||.||...|.....|
||M...|||..|.||.||.|
||..||.||.||.|..||||
|..|...|...||||...||
|.|...||.|.||...|.||
|.|||.|..|.||.|.|.||
|....|..|..|......||
|.|.||.||.||.|.||.||
|.||...||.....|||..O
|.|||.||..||..|..|||
||||||||||||||||||||
